--------------------------------------------------------------------------------------------------------------------------------------------------------------------------------------------------------
--------------------------------------------------------------------------------------------------------------------------------------------------------------------------------------------------------
-----------------------------------------RR------------------------RR-----------------------------------------------------------------------------------------------------------------------------------
----------------------------------------R----------------------------R----------------------------------------------------------------------------------------------------------------------------------
---------------------------------------R------------------------------R---------------------------------------------------------------------------------------------------------------------------------
--------------------------------------R--------------------------------R--------------------------------------------------------------------------------------------------------------------------------
--------------------------------------R--------------------------------R--------------------------------------------------------------------------------------------------------------------------------
--------------------------------------R--------------------------------R---->---------------------------------------------------------------------------------------------------------------------------
--------------------------------------R--<--------------rrrrrrrrrrrrrr-R--------------------------------------------------------------------------------------------------------------------------------
--------------------------------------R--------------------------------R--------------------------------------------------------------------------------------------------------------------------------
--------------------------------------RRRRRRRRRRRRRRRRRRRRRRRRRRRRRRRRRR--------------------------------------------------------------------------------------------------------------------------------
--------------------------------------RRRRRRRRRRRRRRRRRRRRRRRRRRRRRRRRRR---SSSS-------------------------------------------------------------------------------------------------------------------------
--------------------------------------RRRRRRRRRRRRRRRRRRRRRRRRRRRRRRRRRR--------------------------------------------------------------------------------------------------------------------------------