--------------------------------------------------------------------------------------------------------------------------------------------------------------------------------------------------------
---C--------C--------C--------C--------C--------C--------C--------C--------C--------C--------C--------C--------C--------C--------C--------C--------C--------C--------C--------C--------C--------C-------
--C-C------C-C------C-C------C-C------C-C------C-C------C-C------C-C------C-C------C-C------C-C------C-C------C-C------C-C------C-C------C-C------C-C------C-C------C-C------C-C------C-C--r---C-C---r--
-C---C----C---C----C---C----C---C----C---C----C---C----C---C----C---C----C---C----C---C----C---C----C---C----C---C----C---C----C---C----C---C----C---C----C---C----C---C----C---C----C---C----C---C----C
C-----CCCC-----CCCC-----CCCC-----CCCC-----CCCC-----CCCC-----CCCC-----CCCC-----CCCC-----CCCC-----CCCC-----CCCC-----CCCC-----CCCC-----CCCC-----CCCC-----CCCC-----CCCC-----CCCC-----CCCC-----CCCC-----CCCC-
--------------------------------------------------------------------------------------------------------------------------------------------------------------------------------------------------------
--------------------------------------------------------------------------------------------------------------------------------------------------------------------------------------------------------
--------------------------------------------------------------------------------------------------------------------------------------------------------------------------------------------------------
--------------------------------------------------------------------------------------------------------------------------------------------------------------------------------------------------------
--------------------------------------------------------------------------------------------------------------------------------------------------------------------------------------------------------
--<----3-2-1-0---------------------------------------------q---q--q------q-------q-------q------------q---------q-q-q---q-------q-----q---q----qqqqq------qqqqqqqqqqqq--------qqqqqqqqqqqqqqqqq------>--
--------------------------------------------------------------------------------------------------------------------------------------------------------------------------------------------------------
RRRRRRRRRRRRRRRRRRRRRRRRRRRRRRRRRRRRRRRRRRRRRRRRRRRRRRRRRRRRRRRRRRRRRRRRRRRRRRRRRRRRRRRRRRRRRRRRRRRRRRRRRRRRRRRRRRRRRRRRRRRRRRRRRRRRRRRRRRRRRRRRRRRRRRRRRRRRRRRRRRRRRRRRRRRRRRRRRRRRRRRRRRRRRRRRRRRRRRRR