-------=---------=-------------=----------------------------------w-------------------------------------------------------------------------------------------------------------------------------------
------------------------------------------------LLLLLLLLLLLLLLLLLLL-------------------------------------------------------------------------------------------------------------------------------------
---------------------------------\--------------L$L$L$L$L$L#L#L#L#L-------------------------------------------------------------------------------------------------------------------------------------
--------------------------------------------------------------------------------------------------------------------------------------------------------------------------------------------------------
-------|------------------------------------------------------------------------------------------------------------------------------------------------------------------------------------------------
--------------------------------------------------------------------------------------------------------------------------------------------------------------------------------------------------------
-----------/--------------------------------------------------------------------------------------------------------------------------------------------------------------------------------------------
-<-------------=------_------------=----3---------------------------------------------------------------------------------------------------------------------------------------------------------e-->--
---@#$%-------------------------------------------------------------------------------------------------------------------------------------------------------------------------------------------------
DDDDDDDDDDBBBBBBBBBBBBBBBBBBBBBBBBBBBBBBBBBBBBBBBBBBBBBBBBBBBBBBBBBBBBBBBBBBBBBBBBBBBBBBBBBB$BBBBBBBBBBBBBBBBBBBBBBBBBB$BBBBBBBBBBBBBBBBBBBBBBBBBBBBBBBBBBBBBBBBBBBBBB$BBBBBBBBBBBBBBBBBBBBBBBDDDDDDDDDD
DDDDDDDDDD--------------------------------------------------------------------------------R-------------------------------------------%-------------------------------------------------------DDDDDDDDDD
DDDDDDDDDD-------------------------------------------------------------------------------R-R------------------------------------------%-------------------------------------------------------DDDDDDDDDD
DDDDDDDDDD------------------------------------------------------------------------------R---R-----------------------------------------S-------------------------------------------------------DDDDDDDDDD
