--------------------------------------------------------------------------------------------------------------------------------------------------------------------------------------------------------
-----------------------------------------------------------------V--------------------------------------------------------------------------------------------------------------------------------------
------------------------------------------------V----V---V----V--------V--V-----------------------------------------------------------------------------------------------------------------------------
--------------------------------------------------------------------------------------------------------------------------------------------------------------------------------------------------------
-----------------------------------------------V---=SS--_--------------------=--------------------------------------------------------------------------------------------------------------------------
-----------------------DDDDDDDDDDDDDDDDDDDDDD-----------------------------------------------------------------------------------------------------------------------------------------------------------
----------------------DXXXXXXXXXXXXXXXXXXXXXD--------------V----V---------V-----------------------------------------------------------------------------------------------------------------------------
---------RRRRRR------DXXXXXXXXXXXXXXXXXXXXXXD---V--|----V----------V------------------------------------------------------------------------------------------------------------------------------------
---------RJJJJR-----DXXXXXXXXXXXXXXXXXXXXXXXD------------------------------V----------------------------------------------------------------------------------------------------------------------------
-<--3-----JJJJ-------XXXXXXXXXXXXXXXXXXXXXXXD---------V----V----V------>--------------------------------------------------------------------------------------------------------------------------------
----------JJJJ-------XXXXXXXXXXXXXXXXXXXXXXXD-----------------------------------------------------------------------------------------------------------------------------------------------------------
SSSSSSSSSSSSSSSSSSSSSSSSSSSSSSSSSSSSSSSSSSSSSSSSSS---SSSSSSSSSSSSSSSSSSSSSSSSSSSSSSSSSSSSSSSSSSSSSSSSSSSSSSSSSSSSSSSSSSSSSSSSSSSSSSSSSSSSSSSSSSSSSSSSSSSSSSSSSSSSSSSSSSSSSSSSSSSSSSSSSSSSSSSSSSSSSSSSSSS
SSSSSSSSSSSSSSSSSSSSSSSSSSSSSSSSSSSSSSSSSSSSSSSSSSSSSSSSSSSSSSSSSSSSSSSSSSSSSSSSSSSSSSSSSSSSSSSSSSSSSSSSSSSSSSSSSSSSSSSSSSSSSSSSSSSSSSSSSSSSSSSSSSSSSSSSSSSSSSSSSSSSSSSSSSSSSSSSSSSSSSSSSSSSSSSSSSSSSSSS